         Cheick Diallo     Pro Player   :	ufficient game count: 
          Daniel Oturu     Pro Player   :	ufficient game count: 
       Jaime Echenique     Pro Player   :	nsufficient game count: 
       Javin DeLaurier     Pro Player   :	nsufficient game count: 
              Jay Huff     Pro Player   :	fficient game count: 
             Jon Teske     Pro Player   :	ufficient game count: 
           Jordan Bell     Pro Player   :	nsufficient game count: 
          Micah Potter     Pro Player   :	ufficient game count: 
          Norvel Pelle     Pro Player   :	ufficient game count: 
           D.J. Wilson     Pro Player   :	fficient game count: 
         Emanuel Terry     Pro Player   :	ufficient game count: 
          Juwan Morgan     Pro Player   :	sufficient game count: 
          Moses Wright     Pro Player   :	fficient game count: 
            Sam Dekker     Pro Player   :	nsufficient game count: 
       Sekou Doumbouya     Pro Player   :	sufficient game count: 
        Brandon Knight     Pro Player   :	ficient game count: 
          Carlik Jones     Pro Player   :	ficient game count: 
            Cat Barber     Pro Player   :	ufficient game count: 
       Darren Collison     Pro Player   :	ufficient game count: 
        Derrick Walton     Pro Player   :	ufficient game count: 
         Devin Cannady     Pro Player   :	ficient game count: 
       Emmanuel Mudiay     Pro Player   :	sufficient game count: 
    JaQuori McLaughlin     Pro Player   :	fficient game count: 
          Jared Harper     Pro Player   :	ficient game count: 
         Jaysean Paige     Pro Player   :	nsufficient game count: 
          Malik Newman     Pro Player   :	nsufficient game count: 
    McKinley Wright IV     Pro Player   :	ficient game count: 
        Tremont Waters     Pro Player   :	ufficient game count: 
          Tyrell Terry     Pro Player   :	sufficient game count: 
        Zavier Simpson     Pro Player   :	fficient game count: 
            Aleem Ford     Pro Player   :	ficient game count: 
          Anthony Lamb     Pro Player   :	sufficient game count: 
      Arnoldas Kulboka     Pro Player   :	sufficient game count: 
          B.J. Johnson     Pro Player   :	fficient game count: 
       Cameron McGriff     Pro Player   :	ufficient game count: 
        Cameron Oliver     Pro Player   :	sufficient game count: 
        Eugene Omoruyi     Pro Player   :	fficient game count: 
            Feron Hunt     Pro Player   :	sufficient game count: 
           George King     Pro Player   :	fficient game count: 
        Jemerrio Jones     Pro Player   :	sufficient game count: 
             Matt Ryan     Pro Player   :	nsufficient game count: 
            Paris Bass     Pro Player   :	sufficient game count: 
             Tre Scott     Pro Player   :	sufficient game count: 
            Wes Iwundu     Pro Player   :	ufficient game count: 
        Zylan Cheatham     Pro Player   :	nsufficient game count: 
            Ade Murkey     Pro Player   :	nsufficient game count: 
           Ahmad Caver     Pro Player   :	nsufficient game count: 
            C.J. Miles     Pro Player   :	nsufficient game count: 
        Carsen Edwards     Pro Player   :	fficient game count: 
    Chaundee Brown Jr.     Pro Player   :	ficient game count: 
           Craig Sword     Pro Player   :	ufficient game count: 
        Damyean Dotson     Pro Player   :	sufficient game count: 
       DaQuan Jeffries     Pro Player   :	ufficient game count: 
         David Johnson     Pro Player   :	sufficient game count: 
     Deividas Sirvydis     Pro Player   :	ufficient game count: 
         DeJon Jarreau     Pro Player   :	nsufficient game count: 
             Gabe York     Pro Player   :	sufficient game count: 
      Gabriel Lundberg     Pro Player   :	fficient game count: 
        Jaden Springer     Pro Player   :	sufficient game count: 
     Jarron Cumberland     Pro Player   :	ufficient game count: 
         Jaylen Morris     Pro Player   :	ufficient game count: 
           Joe Johnson     Pro Player   :	nsufficient game count: 
        Jordan Goodwin     Pro Player   :	sufficient game count: 
        Jordan Schakel     Pro Player   :	fficient game count: 
           M.J. Walker     Pro Player   :	sufficient game count: 
           Mac McClung     Pro Player   :	sufficient game count: 
           Mason Jones     Pro Player   :	fficient game count: 
           Matt Mooney     Pro Player   :	nsufficient game count: 
        Melvin Frazier     Pro Player   :	ufficient game count: 
           Nate Hinton     Pro Player   :	sufficient game count: 
         Rayjon Tucker     Pro Player   :	ficient game count: 
           Rob Edwards     Pro Player   :	sufficient game count: 
         Scottie Lewis     Pro Player   :	sufficient game count: 
         Scotty Hopson     Pro Player   :	nsufficient game count: 
         Shaq Buchanan     Pro Player   :	sufficient game count: 
    Shaquille Harrison     Pro Player   :	sufficient game count: 
        Trayvon Palmer     Pro Player   :	nsufficient game count: 
            Tyler Hall     Pro Player   :	nsufficient game count: 
          Wayne Selden     Pro Player   :	ufficient game count: 
